#domain
hospital
#levelname
corridors
#colors
red: 0, A
blue: 1, B
purple: Z
#initial
++++++++++++++++++
+ 01             +
+ZZZZ  ZZZZZZZZZZ+
+           A    +
+           B    +
++++++++++++++++++
#goal
++++++++++++++++++
+                +
+ZZZZ  ZZZZZZZZZZ+
+0              A+
+1              B+
++++++++++++++++++
#end
