#domain
hospital
#levelname
follow_issue
#colors
blue: 0, 1
#initial
+++++++++++++
+01         +
+++++++++   +
+           +
+++++++++++++
#goal
+++++++++++++
+           +
+++++++++   +
+10         +
+++++++++++++
#end