#domain
hospital
#levelname
corridors
#colors
red: 0, A
blue: 1, B
purple: Z
#initial
++++++++++++++++++
+01              +
+ZZZZ  ZZZZZZZZZZ+
+          A     +
+          B     +
++++++++++++++++++
#goal
++++++++++++++++++
+                +
+ZZZZ  ZZZZZZZZZZ+
+               A+
+10             B+
++++++++++++++++++
#end