#domain
hospital
#levelname
single_multi
#colors
blue: 0, A, B, C, D
#initial
++++++++++++++
+ 0      ABCD+
+            +
+            +
+            +
+        +++++
+            +
++++++++++++++
#goal
++++++++++++++
+            +
+            +
+            +
+            +
+        +++++
+        ABCD+
++++++++++++++
#end
