#domain
hospital
#levelname
single
#colors
blue: 0, A, B, C, D
#initial
++++++++++++++
+ 0      A   +
+            +
+            +
+            +
+        +++++
+       B    +
++++++++++++++
#goal
++++++++++++++
+            +
+            +
+            +
+            +
+        +++++
+        A   +
++++++++++++++
#end
