#domain
hospital
#levelname
MAPF01
#colors
blue: 0,1,2,3,4,5,6
#initial
+++++++++++++
+           +
+        ++++
+           +
+      ++++ +
+      012+ +
+++++++++++++
#goal
+++++++++++++
+           +
+        ++++
+           +
+      ++++2+
+      0 1+ +
+++++++++++++
#end
