#domain
hospital
#levelname
MAPF01
#colors
blue: 0,1,2,3,4,5,6
#initial
+++++++++++++
+         3 +
+        ++++
+      1    +
+  2    +++ +
+      0  + +
+++++++++++++
#goal
+++++++++++++
+           +
+        ++++
+         2 +
+       +++0+
+        1+3+
+++++++++++++
#end
