#domain
hospital
#levelname
MAPF01
#colors
blue: 0,1
#initial
+++++++++++++
+0    1     +
+        ++++
+           +
+        ++ +
+         + +
+++++++++++++
#goal
+++++++++++++
+           +
+        ++++
+           +
+        ++ +
+        1+0+
+++++++++++++
#end
