#domain
hospital
#levelname
MAPF01
#colors
blue: 0,1,2,3,4,5,6
#initial
+++++++++++++
+           +
+        ++++
+           +
+   +++++++ +
+  3210   + +
+++++++++++++
#goal
+++++++++++++
+  1        +
+        ++++
+           +
+   +++++++0+
+       32+ +
+++++++++++++
#end
