#domain
hospital
#levelname
MAPF01
#colors
blue: 0,1,2,3,4,5,6
#initial
+++++++++++++
+  2      3 +
+        ++++
+      1    +
+  4    +++ +
+      0  + +
+++++++++++++
#goal
+++++++++++++
+           +
+        ++++
+           +
+4      +++0+
+     2  1+3+
+++++++++++++
#end
