#domain
hospital
#levelname
MAsimple1
#colors
red: 0, A, B
green: 1
#initial
++++++++++++++++++++++++++++
+0                       A +
+                          +
+ +++++++++++++++++        +
+                          +
++++++++++++++++++++++++++++
#goal
++++++++++++++++++++++++++++
+                          +
+                          +
+ +++++++++++++++++        +
+                         0+
++++++++++++++++++++++++++++
#end
